....................................00............
.......000000000....000000.........000000.........
......00XXXXXXX000000XXXX00.........00XX0.........
.00...0XX0000XXXXXXXXXXXXX0..........00X0.........
.00...0X00..0XXXXXXXXX00000...........000......00.
.000..0X0...0X00000XXX0................00......00.
.0X0000X0...0X0...000X0................000....0000
.00XXXXX0...000.....0X00..........0....0X0.....0XX
..0XXXXX0...00......00X0........0000...0X00....000
..0XXXXX0000000......000.....0000XX00000X00....00.
..0X00000XXXXX0.......00....00XXXXXXXXXX00.....00.
.0000...0XXXXX00.0......0...000XXXXXXXXX0.........
..00....0XXXXX0..00.....0.....00XXXXXXXX0.........
.00....00XXXXX000000....00.....0X0000XXX0.........
.......0XXXXXX000XX00..000....00X0..0X00000....0..
......00XXX0000.00XX0000X000000XX000000..0000000..
.......0XXX0.....0X000XXXXXXXXXXXXXXX0...0XXXXX00.
......00XXX0.....000.00XX0000XXXXXXX00...00X000X00
.....00XXXX0......0...0XX0..0XXXXXXX0.....000.0X00
...000XXXXX0..000.....0X00..00XXXXX00.........0X0.
..00XXXXXXX0..00......0X0....0XXXXX0........000X0.
.00XXXXX000000000.....000....0XXXX00.........00X0.
00XXXX000.000.00.............0XXX00...........000.
00XXXX0....00....0.........000XX00.............00.
.00XX00...................00XXXX0..............00.
..0XX0......000...0....0000XXXX00...........00000.
..0X00.......000000....00XX00000....000....00XXX0.
..000.......00XXXX00....0000..00...00X0...00XXXX00
..00........0XXXX00.................0000.00XXXX00.
.000.......00XXX00........00.......000...0XXXX00..
.0X00...0000X0000.........00......00X0.00000X00...
.0XX00000XXXX0...........000.....00XX0...0.0X0....
.0XXXXXXXXXXX0...........0X00.....0000.....0X0....
00XXXXXXXXXXX0..........00X0.......00......0X0....
XXXXXXXXXXX000...........000........0......0X00...
00XXXXXXXXX0.............00.......0.0.0....0XX00..
.00000XXXXX0.....00..............000000...00XX00..
.....0XX0000....000.........00....0X0.....00000...
.....0000..0.....000.......0000...0000..0000......
......00...000...0X0000....00X0....0X0..000.......
.00000000...00...0XXXX00....0X0...00X00000......0.
..000..0....000000X0000.....000....0X00........000
....0000...00XXXXXX0...............0X0.......00000
...........0XXXXXXX00..0...........0X00.....00....
..........00XXXXXXXX00000.........00XX0....00.....
..........0XXX0000000000...........0XX00...000....
.........00XX00..00................0XXX0....0000..
........00XX00...0..........00.....0XXX0.....000..
........00000....0..........00....000000..........
........0.0.................0......00.............